NO textures/wall/wall-01.xpm
SO textures/wall/wall-02.xpm
WE textures/wall/wall-03.xpm
EA textures/wall/wall-04.xpm
F 20,20,20
C 200,200,200
111111111111111111111
1N0000000000000000001
111111111111111111111
